aptamer	peptide	label
GCTGCCCAGGGACGTCAACGACCGAGCGTAGATACACTGC	MRPAAGVD	1
TACCTTCGGCCGAAATTTATCTCAAAGTGCAATACCTGCG	MGLGCEYK	1
CGTGTAATAGCCTTCATACCGCATTTGTCCCCACCCTCGC	MQWIRQGY	1
CACCCACTATGTAGTTACCCTCTCTGTAGGACTTCGGACA	MREAHDMV	1
TCAGTTGCGATTAAACTAGCGACTGGCGGACCTCCTGCCC	MVAWAVLV	1
TTTGCTTACTCCAGGCTCTTCGTGATCGACTCCCTCTTTC	MNTRVAGC	1
CATATAATATACCTTCTACCTCCCCCTCCCTACAGGGTGT	MRKLVGRV	1
GCCGGGTTCAACCACCCAGTTTATCCCATTAACCTCCGCT	MGGILSPS	1
CTCATCCATGTCCTCCACCGAGCACACCCCGCAGGCTCTC	MGWWVRRG	1
AACTTTTCCCACATTCATCCTTCGGGTTTCCTGTCCCAAC	MSVKWCGG	1
GTGTCTTCGTCATACCGCCACAATCACCAGTTTCGAGATG	MVPGSGLP	1
ATACCCCAACAGAGTATCATAACTTCCACGGTGCATCTCA	MLTRATLA	1
CGACAAATCCTCACTCTACCCGATTCCCCGTCTTAATCAT	MAVPAVRW	1
TGTACAGGATCCATCTGTTTACCCCCCCAGACTTCTTCGC	MGNGNWEA	1
CAGTCCTTCATTGCACCTCCTCCGACTCGCACAGACAGGT	METACTGV	1
GAATTCTTCTTCTTAAGAACGCACTTGGCAACCCTTTTGA	MLRLLAVG	1
GGCCTGAATCTTCCCTCACATCGTCTTCACCGGAGAAATT	MSKTWGKV	1
GTCCGATCCCGTCAATCATCCACCCCATACTCCTCAGTTT	MFMGWQKG	1
ATTTTGAGTAACCCCACAGTCGTCGCCACATCACTATCTC	MGSGHSFG	1
ATGCGTTGCCGCCATTTCTAGTACCCCGCGACACCCGTAC	MAAYASLV	1
AACCCACCGTCATTATCCCGCACTCCCATGGCAATTGTTA	MPDQRGGQ	1
GCTCACCCTCCCTATCCCCATAGTCCCCTAAGTATAGTGC	MGQRGMWS	1
GCCCTGCCGCTCTGCGAAAGGTAAAACACTCGCTCCCCAG	MKGPFLWQ	1
TATCACCCGTTTAAATTACACTTGCTAAGTCTAGACAACA	MASGVVKL	1
ATGAATCGTCGTCACCTTTGACAACCCCCGCTGCAACCGC	MALLRPLW	1
CCCTGACAATCGCTCACTCCGTCAATAACTTTCACCATAT	MEMGLPRG	1
CGTAACATACCTGCCCATTATTACTTCGTTTTCCGGTCAC	MRGRAALM	1
CAGACTGCCCCCCTCTACTCAGTAGCTTACAAGTTAAGTA	MGALKVRN	1
TCACCAGCCTTTCGTCCCGTACTCCTCGTCATATATCCTC	MHASARQR	1
ATCAGCTTCCATCCTTAGCCTCTTTCGGTGGATTCACCCC	MVVPVLIL	1
CACCTTCACCACAGATCTCGTCCTATAGGTAACACCGGTA	MGNRKGTP	1
GATTTACACTGCTGACCTGTCACTTCTTCACAGTAATTAC	MLPCYEGV	1
ACTAAAGTCCTGTTACCTGTTCGCCCCTGAAAAGCCAATC	MGVRVPER	1
TGTAAGACTCCCTCTTCCCCCACCCATCGTAGTCTACAGC	MFWQGRRS	1
GCCTCCTCCTGATCCCCGCAACCGGACGCCACTAATATAT	MSKMGTCV	1
AGTAATGCGCGTCAAACTTCTCCCTCGCAAAAAATGATCG	MYSRGVGG	1
CCATTGCGTCTCCTTCAAATCACAAAAAATTGACTCCCCG	MGQVGVAA	1
ATCCGTACTTAAAGCACAGAACCGTCTCCCCAAGTCCATG	MGESVSGK	1
GTGATGTAGCCCCACTGAAACTCTAGTCTCAGTAGATTCC	MTCMTRAW	1
GGGTATATGTCTACACTAACCTTCACCTACGGTTGCTCCT	MRAVGTSR	1
TCACGCGCCCCCCTGCTGATTCACGGGTCCCCCACTATTG	MVLALHWA	1
CACACACCGACCGCGATATGCTCTTCTAGCCAAGAACATT	MYRGLRSD	1
TAATCCCATGATAAACCCACACCTATTATCTTAAACGTTG	MAAGMRGW	1
TGAATCCCTATATGTCCCTATGCCTGACCACCATTTGTTT	MWVRPCLS	1
GACTATACCCCTTTGCGAAGTCCTCACCCTACAAGGGATT	MPWAMTGG	1
TTCCCCCTGGCCACATATAGCGTCTGCAGTCATCCTGCTC	MMRPQGLI	1
TACCCCCTCGTCACCTCAATCTTTTGGCTTCTAACACTAG	MGWKAWWL	1
ATCCTTCTCTATATACACTTCCTCATCGTTTCAATATGTG	MMGGDSRT	1
TGTACCCCAAACACCACTCCTTCGCCCGTCAGACTCCGAC	MGVDDTAR	1
CGTACCGACACCTCTCCTTTTCGGAGCATTCGGCTCAAAC	MREGLCRC	1
CCGAACTGCTCGCCAAAATTACGCACCCACTCTCTCCATG	MAWWLDRA	1
TCTATCACGGTAGGCAGGCTCCTTCATTAAGGTTCGCATA	MARWYGQG	1
ATTATCCGCCTCGTCCTTTCTCATACTTACCCTAGAGGAT	MPWVWRHA	1
AATAAAAGAACTCTCTCACCCGTCCCGCCAGTATACCGAA	MSWCRVMI	1
CCCTTACCGTTGCCCCATCAATCCCCTCGGGATCCCGGTG	MGAMRGVA	1
CCCCATTATCGAATGGTCGCTAGCCCCCTGACACGCCCGC	MSGNRGGR	1
CGCCACTTCAATCAAAATGTTTTAAACCTATCTCCTTATA	MQNAQLVG	1
TTTCATGCCGTCTTAAACTGATTCTCCTTGCCCACTAGCT	MLRARKHD	1
CAGAAACCCTCCGCCACGATTCGCCGTACTCCTCGACTTA	MGSNMVLL	1
CCCCCTCCATATACGGTTCTACCCGTAGTACTAGTCATTC	MCSREIYV	1
TCCCCAACCCCGGATATGTCCGCGGCCTGCTTCAGATATC	MLLLDVGM	1
GGGATAAAGCTTGTGTAAACTAACGGCACCAAACCCCTTA	MAWRVDRS	1
TATGAAAGCGTCCCCCAGCCAGATCGTCAACAATTCCCAC	MWLQEGGP	1
CGCCCCCCTTCGCCTAGTTGATATAAGTTCGTCCGGCGCA	MPKGWKIT	1
AGTCCCTCCAATCGGAATAAGCGAAATCGTACCTCTTCAT	MMSRRPEV	1
TCCAAACCGCGCCACACTTCTCTTGTCTAGTTAACACGAT	MGSWMILL	1
TTACAATCGAGAACCCGCCTCCCTGCGCGTCGCATCCCAC	MRLVSRPH	1
AGTAAGGCCTCCTCTAGAGATTTGTATTTCTCCGCCCACT	MLSLVASM	1
CTCGCACCCTCTACACCACCATTCTATACTGGTCCTGCTT	MRCPWRCL	1
TTGCCGATTTAAATTATTTTTGACCACATCCCTTCCCATG	MGPGMLCV	1
TAATGGTTACATTTCCCTTCAGCTTCAATTAAAACAGAGA	MPGKYCTW	1
CACTTAGTACCCCGCTCCCTTATCACATGCTCGTAATATA	MGAWDRMR	1
CTTATTCACGTCCTCCCATGCTCCAAGGTAGATTATTAGT	MLRRPAGM	1
CGACACATCCCCCCACGGTTGTTCGCTCTAAGTATCTTTT	MEKWTVEL	1
CATAGGTAATGTACTGTCATATGGTATCCTCTCACCGATC	MVGRCGVL	1
GGTCCAACGATATGTGACCACCCCTCACAGTATTATCAAT	MVTSGYGL	1
TAAAAGCAGCCCGTATACCTAAACGCCACATCGCTAGGTG	MVLHFMGG	1
ACCTCCACTACCTCTTCATGTTAAACCCCACAGCATTTGT	MRTRNAQR	1
CCCCCAGGATCCCCTCTTATCCAGATGTTTTCCCGCAATC	MHCRMGFL	1
AATCCCTATTATGCAAACTCCTAAGTCAATCGATGGTAGT	MEVNRPLV	1
CTCCACAGTCGATCCATTCCAACGTAACCTGTCTGCCTGG	MSVLDVAK	1
CTGAGTGAACGCCCCTCCGCCACCTATCCTCCCGATGAGC	MGGAGASE	1
ATAATTTCGCCCCACATTCATTATCTCAAACAACATCATG	MMTSVTGA	1
CGCACATCCCTCCCCCCCGGTAGTGCCTACCTCGAGCCAT	MLERLGGL	1
ATACTCTCGATTCCAAATGCGAAAAGGCAGTCCACCGCGC	MAAWLTSG	1
CAGAGAGGCCCCCGATTGTGACGTCCTCATCATGGATCCT	MEPSARRG	1
CCGGCGCCACCCCCCTCAGTATAACCGTACCGCACCTGCG	MRMRRRGG	1
GCGCCCTTCCTGCCATAAATGGTAATGACTAGCTGTGCCA	MGVGPLVA	1
GACATGGCAAATCTAACAGAGTCCCATCATCCCCCCTCAT	MRSYDARG	1
CTTACCCCTATCACAGCCTCCCCACTACCATAACGATGCT	MRQLRMLH	1
ATTAGCCATTCCTAAGATCTTATCAGTGCGTAACCCCGGA	MIVLMRCW	1
TGGGCTGGAATGATACCCTACCGTACACATTTCTTTTATA	MERARSRR	1
ACGAAAGTTTCCTACAATGCTTCAGATCCCCTCTTAAAGG	MTSISRAC	1
TTAGATTCTTATAACATCCTCCTATCTACACCTCCTTCCG	MRYLYLGE	1
GAACGCCAATATTGCCCTCCTTCATACGATCAATAGTGTC	MEVVLASV	1
CTCGCCACATTCACACGCCTTCCCTGTAGACTAGTACCGG	MCRLVWRD	1
AGTTGTCCAGCGCCTTAACGATCTAATATCTCTTTCGTGC	MRECFNSQ	1
TCCAACCGTATTTACAGCCCCCCTACATCTACCACGAGGT	MAGGAPVR	1
ACGTCATGAGTTGCCGCCCCTCCGCCCGACGGGCATCGCC	MRVLPSRE	1
TTTGCCTTCCCTCATGGCACCGATAACACTGCTTACCAAT	MGLWSEWR	1
CCAGTGGCCTCTTCCTATACAATCCAGGTTTTATCACTCA	MSGCVKEM	1
TCACATATGTATATCAAGGGGGGCGTGCAATGACCGTTCC	MRTGHFRI	1
ACACTGTGGACATCGCCCCTTCCTGCCCATAACCCTGCCC	MWKHRSRT	1
ATGTGCTCAGGACCCTCGCCACATCTTGTTTCCCTACCCG	MAPGGDVT	1
ACATAGTCACCCGCCCACACCGCCTGGTACTGCATTGTTC	MLDNRPGE	1
TTGTGATCAGCTCCTGTTCTCTTCTATAACCCTAAGAAGC	MYTRKFMA	1
CACCGGGCCCCACCGTCTTATACGATTTGAATTACTACAT	MLLLSCDA	1
AAAATTCTTCGGCTCTCCTTACAATCAACACCATATCCTT	MLWWHRRA	1
CAACACCGTTCTCCTACACAGTGACACCGCGCTTCTTCCG	MGAEFHRL	1
TAGGGGGTTGGGTAGTCCCCTATGCCATCATTCCCACCGT	MAYCDGMA	1
AACGTCTAATTAACTCTCCAGTCAAATGCCTCCTCTCCGT	MSGLGGSS	1
GCCCCCCCATTAGTGTATACAGTTATACGAGGATTTCTTC	MLIRLWVL	1
ACCCCCATCTCTTTATGTATGCCCTAGACATTCCGATGGT	MLRQGNTR	1
ATATACTTACCCGCCGTACTGCGCCGATTCCTGGCGTATT	MRSRRSWG	1
GCTTTCGTCAAACACACCTCACAAGCGACCCCTAGCCTCG	MAGNGLSL	1
TGTTACTGGTGAAGCAATGTCCCCATCCCCCCAAGTCCCT	MQRRRLRW	1
ATTGGGCGACCCCTCACAAGGCTCCCGCGTCTCCTCACTG	MMAVRGGY	1
CATAATCAAACTAACTCCTTCTCTACCTTACAGCGCCACA	MQEWLFKG	1
AACTAACCTACTGCGCCGTAAAATGTTATCTCAGTACAGA	MGGGHGGE	1
GACCCTCCCGGCCATCCTGGCTATTCCTGTGAGCCGTCCT	MCAICADA	1
GACGCTGTACGAACCGCCGGGACCAACAATCCACAATAGC	MGGAQRAG	1
CCCCCCTTCACGTGCGCCGGTTCATGACCTTCAAATAGGC	MKTWGSLN	1
GTATCAATCGCCCCTTTCCATTGAAATATCATACTTGGTT	MSCMARYE	1
TGCTTATCGATTTCGCTAGGGTCCTCCTATCCCCCGTGTA	MVAVEAIR	1
GACCGACCCCGCCCGACAAAAATCCAGCCACCCAACCCTC	MGYYGGVR	1
TAATATTCAGAAGCTTTCCCGTGTCAGTATATCTCCGCTT	MRLLAVPQ	1
CCTAATATCCCCATAGGCGCGGCTTTTACATCTTGACTGC	MLRGGFEY	1
ACATAAACATGCTACCACACCCTCGTCCCCCCCATCGGCC	MNLDWTAG	1
GATTGATACCCGGGCCCGATTCGTTATATATACTCCTGCG	MCWSLVLG	1
TCCTCCCCCTGCCCCACCGTCCTAGATAATTTGCTCTTAA	MKGTSARS	1
GATAACAACAAGACCCGCTAACTTCCACGTCATGGATTCC	MWPTIGVV	1
CGCCCCCGAGCTTACATAAGCCCCCCGCTACTGCCTCATG	MGSVRLEE	1
CGCTCCACGCCCTCAGCTGTCAGCTAACACTATTGAAACA	MRNSGLLV	1
TCTTATGTCCTCGTATCCTACGCTCTTTCCGTCGTGTGTA	MQLDMLRG	1
CCAAGACAAGATCACGCTCTACCCTCCCAGTCCAGGTCAC	MYVVPMNA	1
CCCTACCTCCCAATCCGTTGCCACCCTATTGCTCCGTATC	MWEQWGEY	1
CCTTAAGTCATCGACACCCCGGGTATCAGACCTTCCCGAA	MRGSRSSK	1
AACTGTTTACGGCACATAATAGGCATCGTTCTCCACACTC	MVRRGAML	1
AGTAAACGTCCGCTGCCTCTCATTCCCCCGCGCCTCAGAC	MKLELLGI	1
ATCAGCCAGTATTGAATTATCGCATCGAACCCCCGCATGG	MRDVMRRV	1
GAGTCACCCACTACCGGTACCCAGACTTGCAACTCCATAC	MCAAEWVT	1
TAACCGTTCAGCTTTTTTAACCTTTTCTCCTGCTGTCTTT	MLAQCTKC	1
AACAATGTCCTCCCTCTGTATCAATATAAGCAATGTCTCT	MLGTLWEF	1
TATGCCTCATTGTAGTTTCCTCCCCCATGTACTACACTCC	MVLSGLIR	1
GAATAGTTCGTTAAGTGTCCATTCCTCGAGTCCCTGCAAA	MRRMATRS	1
CCCGCAATTCACGTCAATAGCTCCCCTAAGAATCTGCATT	MWGKQRMR	1
TATAATTACTCCAACACTTCCATCTCCTTTGTAGATAGTT	MLCGSRWG	1
CATCTAAATTGCGGGTTGCCCTTCCTACGCTTACCTCACA	MAAECLEA	1
TTCCATCGACCCAATGTTGACCTCACCCAATTACTTTTTT	MGEVRWVD	1
TTTACTGACTTTGTTACAACCGTCCTCATTCTCGCCTTCT	MRSGYGAR	1
GCCGCCCGCTGATCTCCTCAATCTTCTTTAATAATGTGCA	MEGTAPVQ	1
CCACTGCGCACTTAGTTACCACAACGTAGTCATAGTCCAT	MLVLVLRG	1
GAATAGGCACTCCCTTACAGTTCGTACCTCCATCTCTCTC	MLGAGGSS	1
ACCTTTTCTAGGGGTATTGTCACACGGCACCCACTGCCTT	MVEEYRGV	1
GGAGTCCTAAATCTTATACTCCTGAATCCCCAAAAACGCA	MLRVRARG	1
GAAAGGATGTACTTTACCGCCCTCGTTCACATCAGAACAA	MESVCDEP	1
GTTAATCTAACCCTTCTCCTCCTATCTTAATCAACTCGCT	MPSLGGLG	1
ATTGCCGTAGCTCGCCGCCTTACTATCCCTTACATAACAG	MTVWSGLW	1
AACATCTTGCCTTTCCCCCCATGCCCGAAAATACTGATCC	MSMFNGVH	1
CCGCCTCCTACTCATCCTCGACACTTTCACCGACCGGTCA	MLVLRVWG	1
AGACCCTTACCATTATCGCTCCGTCAGTTCGGCCTCAGGA	MTGLRRQM	1
GACAAAGATGTAATACCACTATTCTCACTCCACATGCCTT	MRTSGRHI	1
TAACGCACAACTATGTTCACCACTCGTACACTCTTCGAAT	MGLRIYRV	1
GTACCGTTCACCTCCTTATCCTTCTGTATAATACGCTTTA	MPIGCMSQ	1
ACGAGCCTTTCTATAATTTTCATATTTCTTCCATAAGTAA	MVRQKGGS	1
CCGTCTCGAGTTAGTATCGTTCAAGTATCTCCGTAACCTC	MGLRKGSV	1
CGATCTGGCATTCCCTTCGCATGATTTTTTGCCCTGATGC	MNTRSYVV	1
TTACGCTGCGTATTGTGTTGCAGTGGAGTTACCCCCCCGA	MWDGVGLR	1
ACAATTACCGAAGACCCACACTATACCATGATATAAACCC	MPSSEGLF	1
TCTCCCTCATTCGTGAATAACGGAAACGTTCCTCAAGCGT	MGSWGRMH	1
AACCCTATCCTTCGCCTTTTGCTTGTGGTGCACACTGCAC	MPTSVKAG	1
TTTGATTCAAGCTGCTCCACAGACTCATGCATAGGCAACT	MCVLVWRE	1
TCCTTCCTATTGAACCCCTCTTAACGTTTCCGCGCCACAT	MKISRCTE	1
TACGTCAGTCCTGCGCTCTTTTCATCCTTGGCTTCTCGTA	MMLHGQLE	1
GTTCCGCTCCGTGTGCCTCCGTTTGGTCCGATAAAGGGAA	MVQKNTAR	1
TCCCCGCTCTCCAACTCTAAAACTGGCCCCAATCAAAAGT	MKRVDFAS	1
ACCCCTTCCGCATATATATCTCCCAGAAACATTAGGGTAA	MSFIGVHL	1
CATCACGTCTAGTTGCTCCCGTACCGCTCTCGGCCCCTTA	MRIHRRWK	1
AGTAGTATTTGCTCACTCCCCCCTCAAGAGTCCCAGCTTC	MGRGCLVL	1
TCCCCGTCCCGTGATTTACAAACGTCCGCCTCAATGGTTA	MSLSRGFS	1
TGTAATCAGCGCTTGCCCTATATATCCAGACAATGTAAAT	MAHYHRAS	1
ATGTGAGCTCTGTGGCTCCGTTATCACCCCAGCTCTGCTT	MRAALGRG	1
TGCCAAATCTTCACCACAGTCACCCCGATTTGTTAAGTGC	MENKSLWS	1
GGTTATCTCCTTCGTCTTCTCAGTCTGCATGTCCACAATC	MGYPAQDK	1
GAGTTCAGTAATTCGTATCCTCCTTGAGTCTAAATCAACA	MWRERPLV	1
ATCCCTCCGCAACAGTCTTCCAAACACGTGCCCCCGGTGG	MGFCLGAG	1
CCTGTGAAGCCCCTTTCGTTTCCCGCACTCGTCTTGGCCC	MVLFGGRV	1
GACCTCCTCTCAGGCTACACATTCAATGGACGGCCCTTCT	MKMPGRLA	1
AGTAAGCTCGAGGTCCTCCGTTAGACATTATATCCTTGGC	MGQLLMLW	1
CCAAGTCACAATCGGTCCGCCTCGCTCCTTTGATCAGATA	MKRGMWWR	1
ATTCAATTATCCATGAGCCTCGCTGTCCTCCCCCACTTTA	MEVRFQCY	1
CATACTATGATTTCTCATCGTATCTCCCGTGCACCGTGCA	MCRVHLKV	1
ATGGTACGCTGTCCTCTAATACTCAGTCTCCTTGTCCGCG	MGFAMWGL	1
GCGAAGTCAGCCCACATCGTCCGGTCCATATCGCATACCA	MVEDGRES	1
ACTTGTGTTAAAGGCGATCGACAGCCTCCCTAGATAGCGT	MRVVKGVH	1
TCTACAAAGTAACTCGCCGGTCCTCGTCATATCGGGTCTA	MALFAYKT	0
TTCAAACGTTACTAATCCATGCCCCCCACGCTAATCGGCT	MQTRVSTR	1
ACTAGCTTCGAACTGCCTCTCTATTCCCCCTTCCATTCTC	MPPDDRWD	0